11111111111111
1P010C0000C001
10000011101111
10C011E0000001
10010000X0C001
11111111111111