11111111111111
0P010C0000C001
10000011101111
10C011E0000001
1001000000C001
11111111111111