11111111111111
1P010000000001
10000111101111
100011E0000001
10010000000001
11111111111111