11111111111111
10000C0000C001
10000111101111
10C011E0000001
1001000000C001
11111111111111