11111111111111
1P010C0000C001
10000110110111
10C01101E10001
10010000100C01
11111111111111